1111111111111111111111111111111111111111
1000000000000000000000000000000000000001
100000000000000000000000000000C000000001
1000000000000000000000000000000000000001
1000000000000000000000000000000000000001
1000000000000000000000000000000000000001
1000000000000000000000000000000000000001
1000000P00000000000000000000000000000001
1000000000000000000000000000000000000001
1000000000000000000000000000000000000001
1000000000000000000000000000000000000001
10000000000000000000000000C0000000000001
1000000000000000000000000000000000000001
1111111111100000000000000000000000000001
1111111111111000000000000000000000000001
1111111111111100000000000000000000000001
1111111111111110000000CC0000000000000E01
1111111111111110000000000000000000000001
1000000000000000000000000000000000000001
1000000000000000000000000000000000000001
1111111111111111111111111111111111111111
