1111111111111
10010000000C1
1C00011100001
1P0011E000001
11111111111111