1111111111111
10010000M00C1
10000000M0001
1C00011111001
1P0010E000001
1111111111111
