1111111111111
10100000000C1
1C011111000011
1P0010E000001
1111111111111