1111111111111
1M010000000C1
10000000M0001
1C00M11111001
1P0010E000001
1111111111111
