11111111111111111
10C00000000000001
10000000000000001
1000000E000C00001
10000000000000001
10P00000000000001
11111111111111111
